NO ./texture/walls/wall_sn.xpm
SO ./texture/walls/wall_ss.xpm
WE ./texture/walls/wall_sw.xpm
EA ./texture/walls/wall_se.xpm

F 127,10,41
C 64,64,64

        1111111111111111111111111
        1000000000110000000000001
        1011000001110000000000001
111111111011000001110000000000001
100000000011000001111110111111111
11110111111111011100000010001
11110111111111011101010010001
11000000110101011100010010001
10000000000000001100000010001
10000000000000000001010010001
11000001110101011111000000W0111
11111111 1111111 111111111111
