NO ./texture/walls/wall_4.xpm
SO ./texture/walls/bluestone.xpm
WE ./texture/walls/wall_2.xpm
EA ./texture/walls/wall_3.xpm

F 136,45,23
C 119,181,254

        1111111111111111111111111111111111111111111111111111
        10000000001100000000000000000000000000000000000000001
        10110000011100000000001000000011111111001111111100001
        10010000000000000000001000000000000001001000000000001
1111111110110000011100000000000000000000000000000000000000001
100000000011000001110111101111111111111111111111111111111111
11110111111111011100000010001
11110111111111011101010010001
11000000110101011100000010001
10000000000000001100000010001
10000000000000001101010010001
11000001110101011111011100N0111
11110111111101011101111010001
10000000000000000000000000001
10000000000000000000000000001
10000000000000000000000000001
10000000000000000000000000001
10000000000000000000000000001
10000000000000000000000000001
10000000000000000000000000001
10000000000000000000000000001
10000000000000000000000000001
10000000001000001000000000001
10000000000100010000000000001
10000000000010100000000000001
10000000000000000000000000001
11111111111111111111111111111