NO ./texture/walls/wall_sn.xpm
SO ./texture/walls/wall_ss.xpm
WE ./texture/walls/wall_sw.xpm
EA ./texture/walls/wall_se.xpm

F 102,0,0
C 32,32,32

        1111111111111111111111111
        10000000001100000000000A1
        1A110000011100000000000A1
1111111110110000011100000000000A1
10000000001100000111111D111111111
11110111111111011100000010A01
1111D111111111011101010010001
11000000110101011100010010001
10000000000000001100000010001
10000000A00000000D01010010001
11000001110101011111000000N0111
11111111 1111111 111111111111
