NO ./texture/walls/wood.xpm
SO ./texture/walls/greystone.xpm
WE ./texture/walls/redbrick.xpm
EA ./texture/walls/mossy.xpm

F   0,0,153
C 0,0,0

        1111111111111111111111111
        10000000001100000000000A1
        10110000011100000000000A1
        10010000000000000000000A1
1111111110110000011100000000000A1
10000000001100000111111D111111111
11110111111111011100000010A01
1111D111111111011101010010001
11000000110101011100000010001
10000000000000001100000010001
10000000A00000000101010010001
11000001110101011111000000N0111
11110111 1110101 101111010001
11111111 1111111 111111111111
