NO ./texture/walls/wall_ln.xpm
SO ./texture/walls/wall_ls.xpm
WE ./texture/walls/wall_lw.xpm
EA ./texture/walls/wall_le.xpm

F 136,45,23
C 119,181,254

        1111111111111111111111111111111111111111111111111111
        100A00000011000000000000000000000000000000000000000A1
        10110000011100000000001000000011111111001D11111100001
        10D10000000000000000001000000000000001001000000000001
11111111101100000111000000000000000000000000000000000000000A1
100000000011000001111D11101111111111111111111111111111111111
1111D111111111011100000010001
11110111111111011101010010001
11A00000110101011100000010001
100000000000000011000000D0001
10000000000000001101010010001
11000001110101011111A1110000111
11110111111101011101111010001
10000000000000000000000000001
10000000000000000000000000001
1000000000000S000000000000001
10000000000000000000000000001
10000000000000000000000000001
10000000000000000000000000001
10000000000000000000000000001
1000000011111D111110000000001
10000000010000000100000000001
10000000001000001000000000001
10000000000100010000000000001
1000000000001A100000000000001
1A0000000000010000000000000A1
11111111111111111111111111111