NO ./texture/walls/wall_1.xpm
SO ./texture/walls/wall_2.xpm
WE ./texture/walls/wall_3.xpm
EA ./texture/walls/wall_4.xpm

F   50,30,54
C 225,30,50

11111
10001
10N01
10001
11111
