NO ./texture/walls/wall_1.xpm
SO ./texture/walls/wall_2.xpm
WE ./texture/walls/wall_3.xpm
EA ./texture/walls/wall_4.xpm

F   50,30,54
C 225,30,50

1111111111111111111111111111111
1000000000000000000000000000001
1000000111000000000000000000001
1000000000000001000000000000001
1000000000000001000000000000001
10000N0000000010000000000000001
1000000000000000000000000000001
1000000000000001000000000000001
1111111111111111111111111111111
