NO ./texture/walls/wall_1.xpm
SO ./texture/walls/wall_2.xpm
WE ./texture/walls/wall_3.xpm
EA ./texture/walls/wall_3.xpm

F   50,30,54
C 225,30,50

111111111111111111111111111111
100000000000000000000000000001
100000000000000000000000000001
100000000000000000000000000001
100000000000000000000000000001
101110000000000N00000000000001
100000000000000000000000000001
100000000000000000000000000001
100000000000000000000000000001
100000000000000000000000000001
100000000000000000000000000101
100000000000000000000000000001
100000000000000000000000000001
111111111111111111111111111111
