NO ./texture/walls/wall_4.xpm
SO ./texture/walls/bluestone.xpm
WE ./texture/walls/wall_3.xpm
EA ./texture/walls/wall_3.xpm

F   136,45,23
C 119,181,254

111111111111111111111111111111
100000000000000000000000000001
100000000000000000000000000001
100000000000000000000000000001
100000000000000000000000000001
101110000000000N00000000000001
100000000000000000000000000001
100000000000000000000000000001
100000000000000000000000000001
100000000000000000000000000001
100000000000000000000000000101
100000000000000000000000000001
100000000000000000000000000001
111111111111111111111111111111
=======
11111111111
10000000001
10000000001
10000000001
1000W000001
10000000001
10000000001
11111111111
>>>>>>> manon
=======
11111111111111111
10000000000000001
10000000000000001
10000001111000001
10000001000000001
10000001000000001
10000000000000001
10000000000000001
1000N000000000001
11111111111111111
>>>>>>> 08f93d3d91cd6f82fbde6f8798432cfaf7e3bff0
