NO ./texture/walls/wall_4.xpm
SO ./texture/walls/bluestone.xpm
WE ./texture/walls/wall_2.xpm
EA ./texture/walls/wall_3.xpm

F   136,45,23
C 119,181,254

        1111111111111111111111111
        1000000000110000000000001
        1011000001110000000000001
        1001000000000000000000001
111111111011000001110000000000001
100000000011000001110111110111111
1111011111111101110000001A001
11110111111111011101010010001
110000001101010111000000100A1
100000000000000011000000100A1
10000000000000000D01010010001
1100000111010101111100A000N0111
11110111 1110101 101111010001
11111111 1111111 111111111111
