NO ./texture/walls/wall_4.xpm
SO ./texture/walls/bluestone.xpm
WE ./texture/walls/wall_2.xpm
EA ./texture/walls/wall_3.xpm

F 136,45,23
C 119,181,254



1111111111111111111111111111111111111111111111
1111111111A00011111100000001111111111111111111
1111111111A000D0000000000001111111111111111111
1111111111A00011111100000001111111111111111111
11111111111111111111111D1111111111111111111111
1111111111111111111100000001111111111111111111
1111111111111111111100000001111111111111111111
1111111111111111111100000001111111111111111111
1111111111111111111100000001111111111111111111
1111111111111111111100000001111111111111111111
11111111111111111111000N0001111111111111111111
1111111111111111111100000001111111111111111111
1111111111111111111111111111111111111111111111

