NO ./texture/walls/wall_4.xpm
SO ./texture/walls/bluestone.xpm
WE ./texture/walls/wall_2.xpm
EA ./texture/walls/wall_3.xpm

F 136,45,23
C 119,181,254



1111111111111111111111111111111111111111111111
1000000011000011111100000001111100000010000001
1000000011000000000000000000000000000010111101
1000000011000011111100000001111100000000110001
1110111111111111111111101111111100000011110001
1110111111100011111100000001111001111111110001
1110111111110111110100000001111011100000111101
1110111111000000010100000000000000000000111101
1110111111000000010100000000000001100000111101
1110111111000000010100000001111101100000111101
11101111110111110101000N0001111000111111111101
1110000000011111000000000001111000000000000001
1111111111111111111111111111111111111111111111

